0 0 2 0 20 2 2 0 2
2 0 0 0 2 0 0 0 0
2 2 0 0 0 0 0 0 2
0 20 0 0 0 0 0 0 2
0 0 2 1 0 0 20 0 0
0 0 0 0 2 0 0 0 0
0 2 0 0 0 0 0 0 0
0 0 0 2 0 0 0 2 0