0 0 0 0 20 0 0 0 0
0 20 0 0 2 2 0 0 0
2 0 2 20 0 2 0 0 0
2 0 0 2 0 0 0 0 0
2 0 0 0 0 2 0 0 0
2 0 0 0 0 2 0 2 0
0 0 2 0 1 2 0 0 0
0 0 0 0 0 0 2 0 0
0 0 2 0 0 0 0 2 0